//MAP CONVERTED BY dmm2tgm.py THIS HEADER COMMENT PREVENTS RECONVERSION, DO NOT REMOVE
"a" = (
/turf/open/openspace/airless,
/area/template_noop)
"b" = (
/turf/closed/wall/mineral/titanium/nodiagonal,
/area/shuttle/arrival)
"d" = (
/obj/structure/closet/wardrobe/mixed,
/obj/machinery/light{
	dir = 1
	},
/turf/open/floor/mineral/titanium/tiled/blue,
/area/shuttle/arrival)
"e" = (
/obj/structure/shuttle/engine/propulsion/burst{
	dir = 4
	},
/obj/structure/window/reinforced{
	dir = 8
	},
/turf/open/floor/plating,
/area/shuttle/arrival)
"f" = (
/obj/structure/chair{
	dir = 8
	},
/turf/open/floor/mineral/titanium/tiled/blue,
/area/shuttle/arrival)
"h" = (
/turf/open/floor/mineral/titanium/tiled/blue,
/area/shuttle/arrival)
"j" = (
/obj/effect/decal/cleanable/dirt,
/obj/machinery/light,
/turf/open/floor/mineral/titanium/tiled/blue,
/area/shuttle/arrival)
"l" = (
/obj/structure/shuttle/engine/propulsion/burst{
	dir = 4
	},
/obj/docking_port/mobile/arrivals,
/obj/structure/window/reinforced{
	dir = 8
	},
/turf/open/floor/plating,
/area/shuttle/arrival)
"o" = (
/obj/effect/decal/cleanable/dirt,
/turf/open/floor/mineral/titanium/tiled/blue,
/area/shuttle/arrival)
"r" = (
/obj/effect/spawner/structure/window/hollow/reinforced/end{
	dir = 4
	},
/turf/open/floor/plating,
/area/shuttle/arrival)
"v" = (
/turf/closed/wall/mineral/titanium/overspace,
/area/shuttle/arrival)
"y" = (
/obj/effect/decal/cleanable/dirt,
/obj/machinery/vending/sovietsoda,
/turf/open/floor/mineral/titanium/tiled/blue,
/area/shuttle/arrival)
"D" = (
/obj/machinery/door/airlock/titanium{
	name = "Arrivals Shuttle Airlock"
	},
/turf/open/floor/mineral/titanium/tiled/blue,
/area/shuttle/arrival)
"F" = (
/obj/effect/spawner/randomarcade,
/turf/open/floor/mineral/titanium/tiled/blue,
/area/shuttle/arrival)
"I" = (
/obj/item/radio/intercom/directional/south,
/obj/machinery/light,
/turf/open/floor/mineral/titanium/tiled/blue,
/area/shuttle/arrival)
"J" = (
/turf/closed/wall/mineral/titanium,
/area/shuttle/arrival)
"K" = (
/obj/structure/closet/wardrobe/mixed,
/turf/open/floor/mineral/titanium/tiled/blue,
/area/shuttle/arrival)
"L" = (
/obj/structure/chair{
	dir = 8
	},
/obj/effect/decal/cleanable/dirt,
/turf/open/floor/mineral/titanium/tiled/blue,
/area/shuttle/arrival)
"P" = (
/obj/effect/decal/cleanable/dirt,
/turf/closed/wall/mineral/titanium,
/area/shuttle/arrival)
"W" = (
/obj/effect/spawner/structure/window/reinforced,
/turf/open/floor/plating,
/area/shuttle/arrival)
"X" = (
/obj/effect/spawner/structure/window/hollow/reinforced/end{
	dir = 8
	},
/turf/open/floor/plating,
/area/shuttle/arrival)

(1,1,1) = {"
a
v
b
W
b
v
a
"}
(2,1,1) = {"
a
J
J
o
P
J
a
"}
(3,1,1) = {"
a
J
F
o
y
J
a
"}
(4,1,1) = {"
v
J
F
o
o
J
v
"}
(5,1,1) = {"
J
P
h
o
o
J
J
"}
(6,1,1) = {"
D
h
o
o
o
h
D
"}
(7,1,1) = {"
J
d
L
L
L
I
J
"}
(8,1,1) = {"
J
K
f
L
L
o
J
"}
(9,1,1) = {"
X
K
h
o
h
o
X
"}
(10,1,1) = {"
r
K
f
L
f
o
r
"}
(11,1,1) = {"
J
K
f
L
f
o
J
"}
(12,1,1) = {"
J
d
L
L
L
j
J
"}
(13,1,1) = {"
D
o
o
o
o
h
D
"}
(14,1,1) = {"
J
J
o
o
o
J
J
"}
(15,1,1) = {"
v
b
e
l
e
b
v
"}
