"a" = (/turf/template_noop,/area/space)
"b" = (/obj/structure/table/reinforced,/turf/open/floor/mineral/titanium,/area/space)
"e" = (/turf/closed/wall/mineral/titanium,/area/space)
"h" = (/turf/open/floor/glass/reinforced,/area/space)
"j" = (/turf/open/floor/mineral/titanium/tiled,/area/space)
"m" = (/obj/machinery/door/airlock/shuttle{name = "Arrival Shuttle Airlock"},/turf/open/floor/mineral/titanium,/area/space)
"n" = (/obj/machinery/computer{name = "Shuttle computer"},/turf/open/floor/mineral/titanium/tiled,/area/space)
"o" = (/obj/structure/closet/wardrobe/black,/turf/open/floor/mineral/titanium,/area/space)
"q" = (/obj/structure/closet/wardrobe/grey,/turf/open/floor/mineral/titanium,/area/space)
"s" = (/obj/structure/closet/wardrobe/orange,/turf/open/floor/mineral/titanium,/area/space)
"B" = (/turf/closed/wall/mineral/titanium/interior,/area/space)
"D" = (/turf/open/floor/plating,/area/space)
"F" = (/obj/machinery/holopad,/turf/open/floor/mineral/titanium,/area/space)
"G" = (/obj/structure/window/shuttle,/turf/open/floor/plating,/area/space)
"I" = (/obj/structure/closet/wardrobe/yellow,/turf/open/floor/mineral/titanium,/area/space)
"M" = (/obj/structure/shuttle/engine/large,/turf/open/floor/plating,/area/space)
"N" = (/obj/structure/chair/comfy/shuttle{dir = 1},/turf/open/floor/mineral/titanium/tiled,/area/space)
"P" = (/obj/structure/shuttle/engine/propulsion,/turf/open/floor/plating,/area/space)
"Q" = (/obj/structure/shuttle/engine/heater,/obj/structure/window/shuttle,/turf/open/floor/plating,/area/space)
"R" = (/obj/machinery/door/airlock/shuttle{name = "Arrival Shuttle Airlock"},/turf/open/floor/mineral/titanium/tiled,/area/space)
"S" = (/obj/structure/closet/wardrobe/mixed,/turf/open/floor/mineral/titanium,/area/space)
"U" = (/turf/open/floor/mineral/titanium,/area/space)
"V" = (/obj/structure/shuttle/engine/router,/turf/open/floor/plating,/area/space)

(1,1,1) = {"
aaaaaaaaa
aaeGGGeaa
aaGnnnGaa
aeeNjNeea
eeeBReeee
ebbUFUbbe
mUhhhhhUm
eeNNhNNee
aGNNhNNGa
aGNNhNNGa
aGNNhNNGa
eeNNhNNee
mUhhhhhUm
eeqISosee
aeQQQQQea
aeDDVDDea
aaMDPMDaa
"}
