"a" = (/turf/template_noop,/area/template_noop)
"c" = (/obj/machinery/conveyor{dir = 8; id = "QMLoad"},/obj/machinery/door/poddoor{id = "QMLoaddoor"; name = "supply dock loading door"},/turf/open/floor/plating,/area/shuttle/supply)
"f" = (/obj/machinery/light{dir = 8},/turf/open/floor/mineral/titanium/tiled,/area/shuttle/supply)
"i" = (/obj/machinery/door/airlock/titanium{name = "Supply Shuttle Airlock"; req_access_txt = "31"},/obj/docking_port/mobile/supply,/turf/open/floor/plating,/area/shuttle/supply)
"n" = (/obj/structure/shuttle/engine/propulsion/burst/right,/turf/open/floor/plating/airless,/area/shuttle/supply)
"q" = (/obj/machinery/button/door{id = "QMLoaddoor2"; name = "Loading Doors"; pixel_x = 24; pixel_y = 8},/obj/machinery/button/door{id = "QMLoaddoor"; name = "Loading Doors"; pixel_x = 24; pixel_y = -8},/obj/machinery/light{dir = 4},/turf/open/floor/mineral/titanium/tiled,/area/shuttle/supply)
"r" = (/turf/closed/wall/mineral/titanium,/area/shuttle/supply)
"s" = (/obj/machinery/door/airlock/titanium{name = "Supply Shuttle Airlock"; req_access_txt = "31"},/turf/open/floor/plating,/area/shuttle/supply)
"t" = (/obj/machinery/conveyor{dir = 4; id = "QMLoad2"},/obj/machinery/door/poddoor{id = "QMLoaddoor2"; name = "supply dock loading door"},/turf/open/floor/plating,/area/shuttle/supply)
"x" = (/obj/machinery/door/airlock/titanium{name = "Supply Shuttle Airlock"; req_access_txt = "31"},/turf/open/floor/mineral/titanium/tiled,/area/shuttle/supply)
"A" = (/obj/machinery/light{dir = 1},/turf/open/floor/mineral/titanium/tiled,/area/shuttle/supply)
"B" = (/obj/structure/shuttle/engine/propulsion,/turf/open/floor/plating/airless,/area/shuttle/supply)
"D" = (/obj/structure/chair/comfy/shuttle{dir = 1},/turf/open/floor/mineral/titanium/tiled,/area/shuttle/supply)
"E" = (/obj/effect/turf_decal/box/corners{dir = 1},/turf/open/floor/pod,/area/shuttle/supply)
"F" = (/turf/open/floor/mineral/titanium/tiled,/area/shuttle/supply)
"G" = (/obj/structure/window/shuttle,/turf/open/floor/plating/icemoon,/area/shuttle/supply)
"M" = (/turf/open/floor/pod,/area/shuttle/supply)
"N" = (/obj/effect/turf_decal/box/corners{dir = 8},/turf/open/floor/pod,/area/shuttle/supply)
"O" = (/obj/effect/turf_decal/box/corners{dir = 4},/turf/open/floor/pod,/area/shuttle/supply)
"R" = (/obj/structure/shuttle/engine/propulsion/burst/left,/turf/open/floor/plating/airless,/area/shuttle/supply)
"T" = (/obj/machinery/light,/turf/open/floor/mineral/titanium/tiled,/area/shuttle/supply)
"X" = (/obj/structure/shuttle/engine/heater,/obj/structure/window/shuttle,/turf/open/floor/plating/airless,/area/shuttle/supply)
"Z" = (/obj/effect/turf_decal/box/corners,/turf/open/floor/pod,/area/shuttle/supply)

(1,1,1) = {"
arGGGra
aGFAFGa
aGDFDGa
rrrxrrr
rFAFAFr
rFEMOFr
GFMMMFt
GFMMMFs
GfMMMqr
GFMMMFi
GFMMMFc
rFNMZFr
rFTFTFr
rrXXXrr
aRBBBna
"}
