"a" = (/turf/closed/wall/mineral/plastitanium,/area/space)
"C" = (/turf/open/floor/plasteel/dark,/area/space)
"P" = (/obj/effect/spawner/structure/window/plasma/reinforced/plastitanium,/turf/open/space/basic,/area/space)

(1,1,1) = {"
aPa
aCa
aCa
aCa
"}
