//MAP CONVERTED BY dmm2tgm.py THIS HEADER COMMENT PREVENTS RECONVERSION, DO NOT REMOVE
"a" = (
/turf/closed/wall/mineral/titanium/overspace,
/area/shuttle/mining)
"j" = (
/obj/structure/ore_box,
/turf/open/floor/mineral/titanium/tiled/blue,
/area/shuttle/mining)
"q" = (
/turf/open/floor/mineral/titanium/tiled/blue,
/area/shuttle/mining)
"x" = (
/obj/structure/shuttle/engine/propulsion,
/obj/structure/window/reinforced{
	dir = 1
	},
/turf/open/floor/plating/airless,
/area/shuttle/mining)
"y" = (
/obj/structure/closet/crate,
/turf/open/floor/mineral/titanium/tiled/blue,
/area/shuttle/mining)
"D" = (
/obj/machinery/computer/shuttle/mining,
/turf/open/floor/mineral/titanium/tiled/blue,
/area/shuttle/mining)
"F" = (
/obj/effect/spawner/structure/window/hollow/reinforced,
/turf/open/floor/plating/airless,
/area/shuttle/mining)
"J" = (
/obj/structure/chair{
	dir = 1
	},
/turf/open/floor/mineral/titanium/tiled/blue,
/area/shuttle/mining)
"P" = (
/obj/machinery/door/airlock/titanium{
	name = "Mining Shuttle Airlock"
	},
/obj/docking_port/mobile{
	dir = 8;
	dwidth = 3;
	height = 5;
	id = "mining";
	name = "mining shuttle";
	port_direction = 4;
	width = 7
	},
/turf/open/floor/mineral/titanium/tiled/blue,
/area/shuttle/mining)
"Z" = (
/turf/closed/wall/mineral/titanium,
/area/shuttle/mining)

(1,1,1) = {"
a
Z
F
Z
F
Z
a
"}
(2,1,1) = {"
Z
D
J
q
J
y
Z
"}
(3,1,1) = {"
F
q
J
q
J
q
x
"}
(4,1,1) = {"
Z
q
q
q
J
j
Z
"}
(5,1,1) = {"
a
Z
F
P
F
Z
a
"}
